10 10
#####################
#           #       #
########### # ##### #
#   #     #   #     #
# # # # ####### #####
# # # #   #     #   #
### # ### # ####### #
#   #   # #       # #
# ### ### ####### # #
#     #   # #   # # #
# ##### # # # # # # #
# #   # #   # #   # #
# # ### ##### ##### #
# #   #       #     #
# ### ######### ### #
#     #         #   #
##### ##### ##### ###
#   #       # #   # #
# ########### # ### #
#                   #
#####################
